----------------------------------------
|#        |                     |    |E|
|                |                   | |
|--------------------           |    | |
|                          --------- | |
|--------------------|     |         | |
|        |                 |  |------| |
|        |           ------|        |  |
|        |           |        |     |  |
|        |           |        | -----  |
|                    |#       |        |
|- -------           |-----------------|
|        |                    |        |
|        |- ---- ------ ------- |      |
|        |    #| |              |      |
|----    ------- ---------------- -----|
|            |             |           |
|S  |                      |           |
----------------------------------------