----------------------------------------
|                                     S|
|   -----------------------------------|
|   | |  |       |    %---|           E|
|   | |      |      |---   --          |
|   | |--- ----------        --        |
|   |             |            --      |
|   | |--- ---    |              --    |
|   | |  | |#|--  |                --  |
|   | |      |    |               |  ( |
|   | ---------------------     --   | |
|   |                     |   --     | |
|   | |-----------   ---| |  |       |#|
|   | |#       |       -- ---------- --|
|   | |------- |   ----|               |
|   |          |   |     --|     |-- --|
|   |-----------------------     |     |
|                                |  #  |
----------------------------------------