----------------------------------------
|   #||||            ||||#   |         |
|  ||||||||        ||||||||  |      ---|
|  ||||||||        ||||||||  |      ( S|
|    ||||            ||||    |      -- |
|                            |       | |
|                            |       | |
|            ||||            |       | |
|          |||EE|||          |       | |
|          |||  |||          |-- ----| |
|            |~~|            |     |   |
|                                 #| --|
|            $$$$            |-----|   |
|             $$             |         |
|    ||||            ||||    |         |
|  ||||||||        ||||||||  |       |-|
|  ||||||||        ||||||||  | ------|%|
|   #||||            ||||#   |         |
----------------------------------------